-1 -1   -1 -1   -1 -1   -1 -1   -1 -1   00 05   -1 -1   -1 -1   -1 -1   -1 -1   -1 -1   -1 -1   -1 -1   -1 -1   00 05   -1 -1   -1 -1   -1 -1   
-1 -1   -1 -1   -1 -1   23 10   -1 -1   00 05   -1 -1   -1 -1   -1 -1   -1 -1   -1 -1   -1 -1   -1 -1   -1 -1   00 05   -1 -1   23 10   -1 -1   
-1 -1   -1 -1   -1 -1   23 11   -1 -1   00 05   -1 -1   -1 -1   -1 -1   -1 -1   -1 -1   -1 -1   -1 -1   -1 -1   00 05   -1 -1   23 11   -1 -1   
-1 -1   -1 -1   -1 -1   23 10   -1 -1   00 05   49 00   -1 -1   -1 -1   -1 -1   -1 -1   -1 -1   -1 -1   -1 -1   00 05   -1 -1   23 10   -1 -1   
-1 -1   -1 -1   -1 -1   23 11   -1 -1   00 05   49 01   -1 -1   44 02   -1 -1   -1 -1   44 02   -1 -1   -1 -1   00 05   -1 -1   23 11   -1 -1   
-1 -1   -1 -1   -1 -1   23 10   -1 -1   00 05   49 02   -1 -1   44 03   -1 -1   -1 -1   44 03   -1 -1   -1 -1   00 05   -1 -1   23 10   -1 -1   
-1 -1   -1 -1   -1 -1   23 11   -1 -1   00 05   00 05   00 05   00 05   32 08   33 08   00 05   00 05   00 05   00 05   -1 -1   23 11   -1 -1   
-1 -1   -1 -1   -1 -1   -1 -1   -1 -1   -1 -1   -1 -1   -1 -1   -1 -1   -1 -1   -1 -1   -1 -1   -1 -1   -1 -1   -1 -1   -1 -1   -1 -1   -1 -1   
03 06   04 06   -1 -1   -1 -1   -1 -1   -1 -1   -1 -1   -1 -1   -1 -1   -1 -1   -1 -1   -1 -1   -1 -1   -1 -1   -1 -1   -1 -1   -1 -1   -1 -1   
03 07   04 07   -1 -1   -1 -1   -1 -1   -1 -1   -1 -1   -1 -1   -1 -1   -1 -1   -1 -1   -1 -1   -1 -1   -1 -1   -1 -1   -1 -1   -1 -1   -1 -1   
