08 10   08 10   08 10   08 10   08 10   08 10   08 10   08 10   08 10   08 10   08 10   08 10   09 10   -1 -1   -1 -1   -1 -1   -1 -1   -1 -1   
08 10   08 10   08 10   08 10   08 10   08 10   08 10   08 10   08 10   08 10   08 10   08 10   09 10   -1 -1   -1 -1   -1 -1   -1 -1   -1 -1   
08 10   08 10   08 10   08 10   08 10   08 10   08 10   08 10   08 10   08 10   08 10   08 10   09 10   -1 -1   -1 -1   -1 -1   -1 -1   -1 -1   
08 11   08 11   08 11   08 11   08 11   08 11   08 11   08 11   08 11   08 11   08 11   08 11   09 11   -1 -1   -1 -1   -1 -1   -1 -1   -1 -1   
-1 -1   -1 -1   -1 -1   -1 -1   -1 -1   -1 -1   -1 -1   -1 -1   -1 -1   -1 -1   -1 -1   -1 -1   -1 -1   -1 -1   -1 -1   -1 -1   -1 -1   -1 -1   
-1 -1   -1 -1   -1 -1   -1 -1   -1 -1   -1 -1   -1 -1   -1 -1   -1 -1   -1 -1   -1 -1   -1 -1   -1 -1   -1 -1   -1 -1   -1 -1   -1 -1   -1 -1   
-1 -1   -1 -1   -1 -1   -1 -1   -1 -1   -1 -1   -1 -1   -1 -1   -1 -1   -1 -1   -1 -1   -1 -1   -1 -1   -1 -1   -1 -1   -1 -1   -1 -1   -1 -1   
-1 -1   -1 -1   -1 -1   -1 -1   -1 -1   -1 -1   -1 -1   -1 -1   -1 -1   -1 -1   -1 -1   -1 -1   -1 -1   -1 -1   -1 -1   -1 -1   -1 -1   -1 -1   
-1 -1   -1 -1   -1 -1   -1 -1   -1 -1   -1 -1   -1 -1   -1 -1   -1 -1   -1 -1   -1 -1   -1 -1   -1 -1   -1 -1   -1 -1   -1 -1   -1 -1   -1 -1   
-1 -1   -1 -1   -1 -1   -1 -1   -1 -1   -1 -1   -1 -1   -1 -1   -1 -1   -1 -1   -1 -1   -1 -1   -1 -1   -1 -1   -1 -1   -1 -1   -1 -1   -1 -1   
