06 02   06 02   06 02   06 02   06 02   06 02   06 03   06 02   06 03   06 03   06 02   06 02   06 02   06 02   06 03   06 02   06 03   06 03     
06 02   06 03   06 02   13 21   18 21   18 21   18 21   14 21   06 02   06 03   13 21   18 21   18 21   18 21   14 21   06 02   06 02   06 02   
06 03   06 02   06 02   13 22   18 22   18 22   18 22   14 22   06 03   06 02   13 22   18 22   18 22   18 22   14 22   06 02   06 02   06 02   
06 02   06 03   06 02   13 23   15 22   15 22   15 22   14 23   06 02   06 02   13 23   15 22   15 22   15 22   14 23   06 02   06 02   06 03   
06 03   06 02   06 02   17 21   18 21   18 21   18 21   19 21   06 03   06 02   17 21   18 21   18 21   18 21   19 21   06 02   06 03   06 02   
06 02   06 03   06 02   17 22   18 22   18 22   18 22   19 22   06 02   06 03   17 22   18 22   18 22   18 22   19 22   06 02   06 02   06 02   
06 03   06 02   06 02   17 23   18 23   18 23   18 23   19 23   06 03   06 02   17 23   18 23   18 23   18 23   19 23   06 02   06 03   06 03   
06 03   06 03   06 02   06 02   06 02   06 03   06 02   06 02   06 03   06 02   06 02   06 02   06 02   06 03   06 02   06 03   06 02   06 02   
06 02   06 02   06 03   06 02   06 03   06 02   06 03   06 02   06 02   06 02   06 02   06 03   06 02   06 02   06 02   06 02   06 03   06 02   
06 02   06 03   06 02   06 02   06 02   06 03   06 02   06 02   06 03   06 02   06 02   06 02   06 02   06 03   06 02   06 03   06 02   06 02   
