08 10   08 10   08 10   06 02   06 02   06 02   06 03   06 02   06 03   08 10   06 02   06 02   06 02   06 03   06 02   06 03   08 10   08 10   
08 10   08 10   08 10   06 02   06 02   06 02   06 03   06 02   06 03   08 10   06 02   06 02   06 02   06 03   06 02   06 03   08 10   08 10   
08 10   08 10   08 10   06 02   06 02   06 02   06 03   06 02   06 03   08 10   06 02   06 02   06 02   06 03   06 02   06 03   08 10   08 10   
08 10   08 10   08 10   18 23   18 23   18 23   18 23   18 23   08 10   08 10   18 23   18 23   18 23   18 23   18 23   08 10   08 10   08 10   
08 10   08 10   08 10   08 10   08 10   08 10   08 10   08 10   08 10   08 10   08 10   08 10   08 10   08 10   08 10   08 10   08 10   08 10   
08 10   08 10   08 10   08 10   08 10   08 10   08 10   08 10   08 10   08 10   08 10   08 10   08 10   08 10   08 10   08 10   08 10   08 10   
08 10   08 10   08 10   08 10   08 10   08 10   08 10   08 10   08 10   08 10   08 10   08 10   08 10   08 10   08 10   08 10   08 10   08 10   
08 10   08 10   08 10   08 10   08 10   08 10   08 10   08 10   08 10   08 10   08 10   08 10   08 10   08 10   08 10   08 10   08 10   08 10   
08 10   08 10   08 10   08 10   08 10   08 10   08 10   08 10   08 10   08 10   08 10   08 10   08 10   08 10   08 10   08 10   08 10   08 10   
08 10   08 10   08 10   08 10   08 10   08 10   08 10   08 10   08 10   08 10   08 10   08 10   08 10   08 10   08 10   08 10   08 10   08 10   
