08 22   08 22   08 22   08 22   09 22   -2 -2   -1 -1   -2 -2   07 10   08 10   09 10   -2 -2   -1 -1   -1 -1   -1 -1   -1 -1   -1 -1   -1 -1 
08 22   08 22   08 22   08 22   09 22   -2 -2   -1 -1   -2 -2   07 10   08 10   09 10   -2 -2   -1 -1   -1 -1   -1 -1   -1 -1   -1 -1   -1 -1
18 21   08 22   08 22   08 22   09 22   -2 -2   -1 -1   -2 -2   07 10   08 10   09 10   -2 -2   -1 -1   -1 -1   -1 -1   -1 -1   -1 -1   -1 -1    
18 22   14 22   08 22   08 22   09 22   -2 -2   -1 -1   -2 -2   07 10   08 10   09 10   -2 -2   -1 -1   -1 -1   -1 -1   -1 -1   -1 -1   -1 -1
18 23   18 23   08 22   08 22   09 22   -2 -2   -1 -1   -2 -2   07 10   08 10   09 10   -2 -2   -1 -1   -1 -1   -1 -1   -1 -1   -1 -1   -1 -1 
18 21   19 21   08 22   08 22   09 22   -2 -2   -1 -1   -2 -2   07 10   08 10   09 10   -2 -2   -1 -1   -1 -1   -1 -1   -1 -1   -1 -1   -1 -1   
18 23   19 23   08 22   08 22   09 22   -2 -2   -1 -1   -2 -2   07 10   08 10   09 10   -2 -2   -1 -1   -1 -1   -1 -1   -1 -1   -1 -1   -1 -1   
08 22   08 22   08 22   08 22   09 22   -2 -2   -1 -1   -2 -2   07 10   08 10   09 10   -2 -2   -1 -1   -1 -1   -1 -1   -1 -1   -1 -1   -1 -1   
08 22   08 22   08 22   08 22   09 22   -2 -2   -1 -1   -2 -2   07 10   08 10   09 10   -2 -2   -1 -1   -1 -1   -1 -1   -1 -1   -1 -1   -1 -1   
08 22   08 22   08 22   08 22   09 22   -2 -2   -1 -1   -2 -2   07 10   08 10   09 10   -2 -2   -1 -1   -1 -1   -1 -1   -1 -1   -1 -1   -1 -1