08 22   08 22   08 22   08 22   08 22   08 22   08 22   08 22   08 22   08 22   08 22   08 22   08 22   08 22   08 22   08 22   08 22   08 22 
08 22   08 22   08 22   08 22   08 22   08 22   08 22   08 22   08 22   08 22   08 22   08 22   08 22   08 22   08 22   08 22   08 22   08 22
08 22   08 22   08 22   08 22   08 22   08 22   08 22   08 22   08 22   08 22   08 22   08 22   08 22   08 22   08 22   18 21   18 21   18 21    
08 22   08 22   08 22   08 22   08 22   08 22   08 22   08 22   08 22   08 22   08 22   08 22   08 22   08 22   13 23   18 22   18 22   18 22
08 22   08 22   08 22   08 22   08 22   08 22   08 22   08 22   08 22   08 22   08 22   08 22   08 22   08 22   17 21   18 21   18 21   18 21
08 22   08 22   08 22   08 22   08 22   08 22   08 22   08 22   08 22   08 22   08 22   08 22   08 22   08 22   17 22   18 22   18 22   18 22   
08 22   08 22   08 22   08 22   08 22   08 22   08 22   08 22   08 22   08 22   08 22   08 22   08 22   08 22   17 23   18 23   18 23   18 23
08 22   08 22   08 22   08 22   08 22   08 22   08 22   08 22   08 22   08 22   08 22   08 22   08 22   08 22   08 22   08 22   08 22   08 22
08 22   08 22   08 22   08 22   08 22   08 22   08 22   08 22   08 22   08 22   08 22   08 22   08 22   08 22   08 22   08 22   08 22   08 22
08 22   08 22   08 22   08 22   08 22   08 22   08 22   08 22   08 22   08 22   08 22   08 22   08 22   08 22   08 22   08 22   08 22   08 22