08 22   08 22   08 22   08 22   08 22   08 22   08 22   08 22   08 22   08 22   08 22   08 22   08 22   08 22   08 22   08 22   08 22   08 22 
08 22   08 22   08 22   08 22   08 22   08 22   08 22   08 22   08 22   08 22   08 22   18 21   18 21   18 21   18 21   08 22   08 22   08 22 
08 22   08 22   08 22   08 22   08 22   08 22   08 22   08 22   08 22   08 22   13 22   18 22   18 22   18 22   18 22   14 22   08 22   08 22    
08 22   08 22   08 22   08 22   08 22   08 22   08 22   08 22   08 22   08 22   18 23   18 23   18 23   18 23   18 23   18 23   08 22   08 22
08 22   08 22   08 22   08 22   08 22   08 22   08 22   08 22   08 22   08 22   17 21   18 21   18 21   18 21   18 21   19 21   08 22   08 22
08 22   08 22   08 22   08 22   08 22   08 22   08 22   08 22   08 22   08 22   17 22   18 22   18 22   18 22   18 22   19 22   08 22   08 22   
08 22   08 22   08 22   08 22   08 22   08 22   08 22   08 22   08 22   08 22   17 23   18 23   18 23   18 23   18 23   19 23   08 22   08 22
08 22   08 22   08 22   08 22   08 22   08 22   08 22   08 22   08 22   08 22   08 22   08 22   08 22   08 22   08 22   08 22   08 22   08 22
08 22   08 22   08 22   08 22   08 22   08 22   08 22   08 22   08 22   08 22   08 22   08 22   08 22   08 22   08 22   08 22   08 22   08 22
08 22   08 22   08 22   08 22   08 22   08 22   08 22   08 22   08 22   08 22   08 22   08 22   08 22   08 22   08 22   08 22   08 22   08 22