00 00   00 00   00 00   00 00   00 00   00 00   00 00   00 00   00 00   00 00   00 00   00 00   00 00   00 00   00 00   07 10   08 10   06 03   
00 00   00 00   00 00   00 00   00 00   00 00   00 00   00 00   00 00   00 00   00 00   00 00   00 00   00 00   00 00   07 10   08 10   06 03   
00 00   00 00   00 00   00 00   00 00   00 00   00 00   00 00   00 00   00 00   00 00   00 00   00 00   00 00   00 00   07 10   08 10   06 02   
00 00   00 00   00 00   00 00   00 00   00 00   00 00   00 00   00 00   00 00   00 00   00 00   00 00   00 00   00 00   07 10   08 10   06 03  
00 00   00 00   00 00   00 00   00 00   00 00   00 00   00 00   00 00   00 00   00 00   00 00   00 00   00 00   00 00   07 10   08 10   06 02   
00 00   00 00   00 00   00 00   00 00   00 00   00 00   00 00   00 00   00 00   00 00   00 00   00 00   00 00   00 00   07 10   08 10   06 03   
00 00   00 00   00 00   00 00   00 00   00 00   00 00   00 00   00 00   00 00   00 00   00 00   00 00   00 00   00 00   07 10   08 10   06 03   
00 00   00 00   00 00   00 00   00 00   00 00   00 00   00 00   00 00   00 00   00 00   00 00   00 00   00 00   00 00   07 10   08 10   06 02   
00 00   00 00   00 00   00 00   00 00   00 00   00 00   00 00   00 00   00 00   00 00   00 00   00 00   00 00   00 00   07 10   08 10   06 03  
00 00   00 00   00 00   00 00   00 00   00 00   00 00   00 00   00 00   00 00   00 00   00 00   00 00   00 00   00 00   07 10   08 10   06 03   
