1 -1  -1 -1  -1 -1   -1 -1  -1 -1  -1 -1  -1 -1  00 05  -1 -1  -1 -1  -1 -1  00 05  00 05  -1 -1  00 05  -1 -1  -1 -1  -1 -1
1 -1  -1 -1  55 22   -1 -1  -1 -1  -1 -1  -1 -1  00 05  -1 -1  -1 -1  -1 -1  -1 -1  -1 -1  00 05  00 05  -1 -1  -1 -1  -1 -1
1 -1  -1 -1  -1 -1   -1 -1  -1 -1  -1 -1  -1 -1  00 05  -1 -1  -1 -1  -1 -1  -1 -1  -1 -1  -1 -1  -1 -1  -1 -1  -1 -1  16 05
1 -1  -1 -1  -1 -1   -1 -1  56 20  -1 -1  -1 -1  00 05  -1 -1  -1 -1  -1 -1  -1 -1  -1 -1  00 05  00 05  -1 -1  -1 -1  -1 -1
1 -1  -1 -1  -1 -1   -1 -1  -1 -1  -1 -1  -1 -1  00 05  -1 -1  -1 -1  -1 -1  00 05  00 05  -1 -1  -1 -1  00 05  00 05  54 24
00 05  00 05  00 05  00 05  00 05  00 05  -1 -1  00 05  -1 -1  -1 -1  -1 -1  00 05  -1 -1  56 24  -1 -1  -1 -1  -1 -1  -1 -1
-1 -1  -1 -1  -1 -1  -1 -1  -1 -1  00 05  -1 -1  00 05  -1 -1  -1 -1  -1 -1  00 05  -1 -1  -1 -1  -1 -1  -1 -1  -1 -1  -1 -1
27 11  27 11  17 09  17 09  -1 -1  00 05  -1 -1  00 05  -1 -1  -1 -1  -1 -1  00 05  -1 -1  -1 -1  -1 -1  -1 -1  -1 -1  -1 -1
17 09  27 11  27 11  27 09  -1 -1  00 05  -1 -1  00 05  -1 -1  -1 -1  -1 -1  00 05  -1 -1  -1 -1  -1 -1  55 24  -1 -1  -1 -1
27 11  17 09  17 09  27 10  -1 -1  00 05  -1 -1  00 05  -1 -1  -1 -1  -1 -1  00 05  -1 -1  -1 -1  -1 -1  -1 -1  -1 -1  -1 -1