07 09  08 09  08 09  08 09  08 09  08 09  08 09  08 09  08 09  08 09  08 09  08 09  08 09  08 09  08 09  08 09  08 09  09 09   
07 10  08 10  08 10  08 10  08 10  08 10  08 10  08 10  08 10  08 10  08 10  08 10  08 10  08 10  08 10  08 10  08 10  09 10
07 10  08 10  08 10  08 10  08 10  08 10  08 10  08 10  08 10  08 10  08 10  08 10  08 10  08 10  08 10  08 10  08 10  09 10 
07 10  08 10  08 10  08 10  08 10  08 10  08 10  08 10  08 10  08 10  08 10  08 10  08 10  08 10  08 10  08 10  08 10  09 10  
07 10  08 10  08 10  08 10  08 10  08 10  08 10  08 10  08 10  08 10  08 10  08 10  08 10  08 10  08 10  08 10  08 10  09 10
07 10  08 10  08 10  08 10  08 10  08 10  08 10  08 10  08 10  08 10  08 10  08 10  08 10  08 10  08 10  08 10  08 10  09 10 
07 10  08 10  08 10  08 10  08 10  08 10  08 10  08 10  08 10  08 10  08 10  08 10  08 10  08 10  08 10  08 10  08 10  09 10  
07 10  08 10  08 10  08 10  08 10  08 10  08 10  08 10  08 10  08 10  08 10  08 10  08 10  08 10  08 10  08 10  08 10  09 10
07 10  08 10  08 10  08 10  08 10  08 10  08 10  08 10  08 10  08 10  08 10  08 10  08 10  08 10  08 10  08 10  08 10  09 10 
07 11  08 11  08 11  08 11  08 11  08 11  08 11  08 11  08 11  08 11  08 11  08 11  08 11  08 11  08 11  08 11  08 11  09 11