-1 -1   -1 -1   -1 -1   -1 -1   -1 -1   -1 -1   00 05   00 05   42 22   00 05   00 05   00 05   00 05   -1 -1   -1 -1   -1 -1   -1 -1   -1 -1
-1 -1   -1 -1   -1 -1   -1 -1   -1 -1   -1 -1   00 05   -1 -1   41 22   -1 -1   -1 -1   -1 -1   00 05   -1 -1   -1 -1   -1 -1   -1 -1   -1 -1
-1 -1   -1 -1   -1 -1   -1 -1   -1 -1   -1 -1   00 05   -1 -1   -1 -1   -1 -1   -1 -1   -1 -1   00 05   -1 -1   -1 -1   -1 -1   -1 -1   -1 -1
-1 -1   -1 -1   -1 -1   -1 -1   -1 -1   -1 -1   00 05   -1 -1   -1 -1   -1 -1   34 18   -1 -1   00 05   -1 -1   -1 -1   -1 -1   -1 -1   -1 -1
-1 -1   -1 -1   -1 -1   -1 -1   -1 -1   -1 -1   00 05   -1 -1   -1 -1   -1 -1   -1 -1   -1 -1   00 05   -1 -1   -1 -1   -1 -1   -1 -1   -1 -1
-1 -1   -1 -1   -1 -1   -1 -1   -1 -1   -1 -1   00 05   -1 -1   -1 -1   -1 -1   -1 -1   -1 -1   00 05   -1 -1   -1 -1   -1 -1   -1 -1   -1 -1
-1 -1   -1 -1   -1 -1   -1 -1   -1 -1   -1 -1   00 05   00 05   00 05   00 05   00 05   00 05   00 05   -1 -1   -1 -1   -1 -1   -1 -1   -1 -1
-1 -1   -1 -1   -1 -1   -1 -1   -1 -1   -1 -1   -1 -1   -1 -1   -1 -1   -1 -1   -1 -1   -1 -1   -1 -1   -1 -1   -1 -1   -1 -1   -1 -1   -1 -1
-1 -1   -1 -1   -1 -1   -1 -1   -1 -1   -1 -1   -1 -1   -1 -1   -1 -1   -1 -1   -1 -1   -1 -1   -1 -1   -1 -1   -1 -1   -1 -1   -1 -1   -1 -1
-1 -1   -1 -1   -1 -1   -1 -1   -1 -1   -1 -1   -1 -1   -1 -1   -1 -1   -1 -1   -1 -1   -1 -1   -1 -1   -1 -1   -1 -1   -1 -1   -1 -1   -1 -1