00 05   00 05   00 05   00 05   00 05   00 05   00 05   00 05   00 05   00 05   00 05   00 05   00 05   00 05   00 05   00 05   00 05   00 05
00 05   00 05   00 05   00 05   00 05   00 05   00 05   00 05   00 05   00 05   00 05   00 05   00 05   00 05   00 05   00 05   00 05   00 05
00 05   00 05   00 05   00 05   00 05   38 16   39 16   39 16   39 16   39 16   39 16   39 16   40 16   00 05   00 05   00 05   00 05   00 05
00 05   00 05   00 05   00 05   00 05   35 15   34 15   34 15   34 15   34 15   34 15   34 15   37 15   00 05   00 05   00 05   00 05   00 05
00 05   00 05   00 05   00 05   00 05   00 05   00 05   00 05   10 14   12 14   00 05   00 05   00 05   00 05   00 05   00 05   00 05   00 05
00 05   00 05   00 05   00 05   00 05   00 05   00 05   00 05   10 14   12 14   00 05   00 05   00 05   00 05   00 05   00 05   00 05   00 05
00 05   00 05   19 06   21 06   20 06   00 05   00 05   00 05   10 14   12 14   00 05   00 05   00 05   19 06   21 06   20 06   00 05   00 05
00 05   00 05   00 05   00 05   00 05   00 05   00 05   00 05   10 14   12 14   00 05   00 05   00 05   00 05   00 05   00 05   00 05   00 05
00 05   00 05   00 05   00 05   00 05   00 05   00 05   00 05   10 14   12 14   00 05   00 05   00 05   00 05   00 05   00 05   00 05   00 05
00 05   00 05   00 05   00 05   00 05   00 05   00 05   00 05   10 14   12 14   00 05   00 05   00 05   00 05   00 05   00 05   00 05   00 05