08 22   08 22   08 22   08 22   08 22   08 22   08 22   08 22   08 22   08 22   08 22   08 22   08 22   08 22   08 22   08 22   08 22   08 22 
08 22   08 22   08 22   08 22   08 22   08 22   08 22   08 22   08 22   08 22   08 22   08 22   08 22   08 22   08 22   08 22   08 22   08 22
08 22   08 22   08 22   08 22   08 22   08 22   08 22   08 22   08 22   08 22   08 22   08 22   08 22   08 22   08 22   08 22   08 22   08 22    
08 22   08 22   08 22   08 22   08 22   08 22   08 22   08 22   08 22   08 22   08 22   08 22   08 22   08 22   08 22   08 22   08 22   08 22
08 22   08 22   08 22   08 22   08 22   08 22   08 22   08 22   08 22   08 22   08 22   08 22   08 22   08 22   08 22   08 22   08 22   08 22  
08 23   08 23   08 23   08 23   08 23   08 23   08 23   08 23   08 23   08 23   08 23   08 23   08 23   08 23   08 23   08 23   08 23   08 23   
-2 -2   -2 -2   -2 -2   -2 -2   -2 -2   -2 -2   -2 -2   -2 -2   -2 -2   -2 -2   -2 -2   -2 -2   -2 -2   -2 -2   -2 -2   -2 -2   -2 -2   -2 -2
-1 -1   -1 -1   -1 -1   -1 -1   -1 -1   -1 -1   -1 -1   -1 -1   -1 -1   -1 -1   -1 -1   -1 -1   -1 -1   -1 -1   -1 -1   -1 -1   -1 -1   -1 -1
-1 -1   -1 -1   -1 -1   -1 -1   -1 -1   -1 -1   -1 -1   -1 -1   -1 -1   -1 -1   -1 -1   -1 -1   -1 -1   -1 -1   -1 -1   -1 -1   -1 -1   -1 -1
-1 -1   -1 -1   -1 -1   -1 -1   -1 -1   -1 -1   -1 -1   -1 -1   -1 -1   -1 -1   -1 -1   -1 -1   -1 -1   -1 -1   -1 -1   -1 -1   -1 -1   -1 -1