1 26   0 0   0 0   0 0   0 0   0 0   0 0   0 0   0 0   0 0   0 0   0 0   0 0   0 0   0 0   0 0   0 0   0 0
1 26   1 26   0 0   0 0   0 0   0 0   0 0   0 0   0 0   0 0   0 0   0 0   0 0   0 0   0 0   0 0   0 0   0 0
0 0   1 26   1 26   0 0   0 0   0 0   0 0   2 6   3 6   4 6   0 0   0 0   0 0   0 0   0 0   0 0   0 0   0 0
0 0   0 0   1 26   1 26   0 0   0 0   0 0   2 7   3 7   4 7   0 0   0 0   0 0   0 0   0 0   0 0   0 0   0 0
0 0   0 0   0 0   1 26   1 26   0 0   0 0   2 8   3 8   4 8   0 0   0 0   0 0   0 0   0 0   0 0   0 0   0 0
0 0   0 0   0 0   0 0   1 26   1 26   1 26   1 26   1 26   1 26   1 26   1 26   1 26   1 26   1 26   1 26   1 26   1 26
0 0   0 0   0 0   0 0   0 0   0 0   0 0   1 26   0 0   0 0   0 0   0 0   0 0   0 0   0 0   0 0   0 0   0 0
0 0   0 0   0 0   0 0   0 0   0 0   0 0   1 26   0 0   0 0   0 0   0 0   0 0   0 0   0 0   0 0   0 0   0 0
0 0   0 0   0 0   0 0   0 0   0 0   0 0   1 26   0 0   0 0   0 0   0 0   0 0   0 0   0 0   0 0   0 0   0 0
0 0   0 0   0 0   0 0   0 0   0 0   0 0   1 26   0 0   0 0   0 0   0 0   0 0   0 0   0 0   0 0   0 0   0 0