0 5   0 5   0 5   0 5   0 5   0 5   0 5   0 5   0 5   0 5   0 5   0 5   0 5   0 5   0 5   0 5   0 5   0 5
0 5   0 5   0 5   0 5   0 5   0 5   0 5   0 5   0 5   0 5   0 5   0 5   0 5   0 5   0 5   0 5   0 5   0 5
0 5   0 5   0 5   0 5   0 5   0 5   0 5   0 5   0 5   0 5   0 5   0 5   0 5   0 5   0 5   0 5   0 5   0 5
0 5   0 5   0 5   0 5   0 5   0 5   0 5   0 5   0 5   0 5   0 5   0 5   0 5   0 5   0 5   0 5   0 5   0 5
0 5   0 5   0 5   0 5   0 5   0 5   0 5   0 5   0 5   0 5   0 5   0 5   0 5   0 5   0 5   0 5   0 5   0 5
0 5   0 5   0 5   0 5   0 5   0 5   0 5   0 5   0 5   0 5   0 5   0 5   0 5   0 5   0 5   0 5   0 5   0 5
0 5   0 5   0 5   0 5   0 5   0 5   0 5   0 5   0 5   0 5   0 5   0 5   0 5   0 5   0 5   0 5   0 5   0 5
0 5   0 5   0 5   0 5   0 5   0 5   0 5   0 5   0 5   0 5   0 5   0 5   0 5   0 5   0 5   0 5   0 5   0 5
0 5   0 5   0 5   0 5   0 5   0 5   0 5  0 5   0 5   0 5   0 5   0 5   0 5   0 5   0 5   0 5   0 5   0 5
13 9   13 9   13 9   13 9   13 9   13 9   13 9   13 9  13 9   13 9   13 9   13 9   13 9   13 9   13 9   13 9   13 9   13 9
