8 9   8 9   9 9   -1 -1   -2 -2   -2 -2   -2 -2   20 21   25 21   21 21   -2 -2   -2 -2   -2 -2   -2 -2   -2 -2   -2 -2   -2 -2   -2 -2
8 11   8 10   9 10   -1 -1   -2 -2   -2 -2   -2 -2   20 22   25 22   21 22   -2 -2   -2 -2   -2 -2   -2 -2   -2 -2   -2 -2   -2 -2   -2 -2
-1 -1   7 10   9 10   -1 -1   -2 -2   -2 -2   -2 -2   20 23   22 22   21 23   -2 -2   -2 -2   -2 -2   -2 -2   -2 -2   -2 -2   -2 -2   -2 -2
-1 -1   7 10   9 10   -1 -1   -1 -1   -2 -2   -2 -2   24 22   25 22   26 22   -2 -2   -2 -2   -2 -2   -2 -2   -2 -2   -2 -2   -2 -2   -2 -2
-1 -1   7 10   8 10   9 9   -1 -1   -1 -1   -1 -1   24 23   25 23   26 23   -1 -1   -1 -1   -1 -1   -1 -1   -1 -1   -1 -1   -1 -1   -1 -1
-1 -1   7 11   8 10   8 10   8 9   8 9   8 9   8 10   8 10   8 10   8 9   8 9   8 9   8 9   8 9   8 9   8 9   8 9
-1 -1   -1 -1   7 11   8 11   8 11   8 11   8 10   8 10   8 11   8 11   8 11   8 11   8 11   8 11   8 11   8 11   8 11   8 11
-2 -2   -1 -1   -1 -1   -1 -1   -1 -1   -1 -1   7 10   9 10   -1 -1   -1 -1   -1 -1   -1 -1   -1 -1   -1 -1   -1 -1   -1 -1   -1 -1   -1 -1
-2 -2   -2 -2   -2 -2   -2 -2   -2 -2   -1 -1   7 10   9 10   -1 -1   -2 -2   -2 -2   -2 -2   -2 -2   -2 -2   -2 -2   -2 -2   -2 -2   -2 -2
-2 -2   -2 -2   -2 -2   -2 -2   -2 -2   -1 -1   7 10   9 10   -1 -1   -2 -2   -2 -2   -2 -2   -2 -2   -2 -2   -2 -2   -2 -2   -2 -2   -2 -2