-1 -1   -1 -1   -1 -1   -1 -1   -1 -1   -1 -1   -1 -1   -1 -1   -1 -1   -1 -1   -1 -1   -1 -1   -1 -1   -1 -1   -1 -1   -1 -1   -1 -1   -1 -1   
-1 -1   -1 -1   -1 -1   00 05   00 05   00 05   00 05   00 05   -1 -1   -1 -1   00 05   00 05   00 05   00 05   00 05   -1 -1   -1 -1   -1 -1   
-1 -1   -1 -1   -1 -1   00 05   -1 -1   -1 -1   -1 -1   00 05   -1 -1   -1 -1   00 05   -1 -1   -1 -1   -1 -1   00 05   -1 -1   -1 -1   -1 -1   
-1 -1   -1 -1   -1 -1   00 05   -1 -1   -1 -1   -1 -1   00 05   -1 -1   -1 -1   00 05   -1 -1   -1 -1   -1 -1   00 05   -1 -1   -1 -1   -1 -1   
-1 -1   -1 -1   -1 -1   51 06   44 04   -1 -1   -1 -1   00 05   -1 -1   -1 -1   51 03   47 00   -1 -1   47 00   00 05   -1 -1   21 00   -1 -1   
-1 -1   -1 -1   -1 -1   00 05   -1 -1   -1 -1   -1 -1   00 05   -1 -1   -1 -1   00 05   -1 -1   -1 -1   -1 -1   00 05   -1 -1   -1 -1   -1 -1   
-1 -1   -1 -1   -1 -1   00 05   00 05   38 00   44 07   27 07   -1 -1   -1 -1   00 05   44 07   33 01   00 05   27 07   -1 -1   -1 -1   -1 -1   
-1 -1   -1 -1   -1 -1   -1 -1   -1 -1   -1 -1   -1 -1   -1 -1   -1 -1   -1 -1   -1 -1   -1 -1   -1 -1   -1 -1   -1 -1   -1 -1   -1 -1   -1 -1   
-1 -1   -1 -1   -1 -1   -1 -1   -1 -1   -1 -1   -1 -1   -1 -1   -1 -1   -1 -1   -1 -1   -1 -1   -1 -1   -1 -1   -1 -1   -1 -1   02 06   03 06   
-1 -1   -1 -1   -1 -1   -1 -1   -1 -1   -1 -1   -1 -1   -1 -1   -1 -1   -1 -1   -1 -1   -1 -1   -1 -1   -1 -1   -1 -1   -1 -1   02 07   03 07   
