06 02   06 03   06 02   06 02   06 02   06 03   06 02   06 02   06 02   06 02   06 02   06 03   06 02   06 03   06 02   06 03   06 02   06 02   
06 02   06 02   06 02   20 21   25 21   25 21   25 21   21 21   06 02   06 02   34 21   39 21   39 21   39 21   35 21   06 02   06 02   06 02  
06 03   06 02   06 03   20 22   25 22   25 22   25 22   21 22   06 02   06 02   34 22   39 22   39 22   39 22   35 22   06 02   06 03   06 03   
06 02   06 02   06 03   20 23   22 22   22 22   22 22   21 23   06 02   06 02   34 23   36 22   36 22   36 22   35 23   06 03   06 02   06 03   
06 03   06 02   06 02   24 21   25 21   25 21   25 21   26 21   06 02   06 02   38 21   39 21   39 21   39 21   40 21   06 02   06 02   06 02   
06 03   06 02   06 02   24 22   25 22   25 22   25 22   26 22   06 02   06 02   38 22   39 22   39 22   39 22   40 22   06 03   06 03   06 03  
06 02   06 02   06 03   24 23   25 23   25 23   25 23   26 23   06 02   06 02   38 23   39 23   39 23   39 23   40 23   06 02   06 02   06 02  
06 03   06 03   06 02   06 02   06 02   06 03   06 02   06 02   06 03   06 02   06 02   06 02   06 02   06 03   06 02   06 03   06 02   06 03   
06 02   06 02   06 03   06 02   06 03   06 02   06 03   06 02   06 02   06 02   06 02   06 03   06 02   06 02   06 02   06 02   06 03   06 03   
06 02   06 02   06 02   06 02   06 02   06 02   06 02   06 02   06 02   06 02   06 02   06 02   06 02   06 02   06 02   06 02   06 02   06 02  
