17 09   17 09   17 09   17 09   -1 -1   -1 -1   -1 -1   00 05   -1 -1   -1 -1   -1 -1   00 05   -1 -1   -1 -1   -1 -1   -1 -1   -1 -1   -1 -1
-1 -1   -1 -1   -1 -1   -1 -1   -1 -1   -1 -1   -1 -1   00 05   -1 -1   -1 -1   -1 -1   00 05   -1 -1   -1 -1   -1 -1   -1 -1   -1 -1   -1 -1
-1 -1   -1 -1   -1 -1   -1 -1   -1 -1   -1 -1   -1 -1   00 05   -1 -1   -1 -1   -1 -1   00 05   -1 -1   -1 -1   -1 -1   -1 -1   56 23   -1 -1
-1 -1   -1 -1   -1 -1   -1 -1   -1 -1   -1 -1   -1 -1   00 05   -1 -1   -1 -1   -1 -1   00 05   -1 -1   54 23   -1 -1   -1 -1   -1 -1   -1 -1
00 05   00 05   00 05   00 05   00 05   00 05   00 05   00 05   -1 -1   -1 -1   -1 -1   00 05   -1 -1   -1 -1   -1 -1   -1 -1   -1 -1   -1 -1
-1 -1   -1 -1   -1 -1   -1 -1   -1 -1   -1 -1   -1 -1   -1 -1   -1 -1   -1 -1   -1 -1   00 05   -1 -1   -1 -1   -1 -1   -1 -1   -1 -1   -1 -1
-1 -1   -1 -1   -1 -1   -1 -1   -1 -1   -1 -1   -1 -1   -1 -1   -1 -1   -1 -1   20 00   00 05   -1 -1   -1 -1   -1 -1   -1 -1   -1 -1   -1 -1
00 05   00 05   00 05   00 05   00 05   00 05   00 05   00 05   -1 -1   -1 -1   -1 -1   00 05   -1 -1   -1 -1   -1 -1   55 23   -1 -1   -1 -1
-1 -1   -1 -1   -1 -1   -1 -1   -1 -1   00 05   -1 -1   00 05   -1 -1   -1 -1   -1 -1   00 05   -1 -1   -1 -1   -1 -1   -1 -1   -1 -1   -1 -1
-1 -1   -1 -1   -1 -1   -1 -1   -1 -1   00 05   -1 -1   00 05   -1 -1   -1 -1   -1 -1   00 05   -1 -1   -1 -1   -1 -1   -1 -1   -1 -1   -1 -1