08 10   08 10   08 10   08 10   09 10   -1 -1   -1 -1   -2 -2   07 10   08 10   09 10   -2 -2   -1 -1   -1 -1   -1 -1   -1 -1   -1 -1   -1 -1 
08 11   08 11   08 11   08 11   09 11   -1 -1   -1 -1   -2 -2   07 10   08 10   09 10   -2 -2   -1 -1   -1 -1   -1 -1   -1 -1   -1 -1   -1 -1
-1 -1   -1 -1   -1 -1   -1 -1   -1 -1   -1 -1   -1 -1   -2 -2   07 10   08 10   09 10   -2 -2   -1 -1   -1 -1   -1 -1   -1 -1   -1 -1   -1 -1    
-1 -1   -1 -1   -1 -1   -1 -1   -1 -1   -1 -1   -1 -1   -2 -2   07 10   08 10   09 10   -2 -2   -1 -1   -1 -1   -1 -1   -1 -1   -1 -1   -1 -1
-2 -2   -2 -2   -2 -2   -2 -2   -2 -2   -2 -2   -2 -2   -2 -2   07 10   08 10   09 10   -2 -2   -1 -1   -1 -1   -1 -1   -1 -1   -1 -1   -1 -1 
08 09   08 09   08 09   08 09   08 09   08 09   08 09   08 09   08 10   08 10   09 10   -2 -2   -1 -1   -1 -1   -1 -1   -1 -1   -1 -1   -1 -1   
08 11   08 11   08 11   08 11   08 11   08 11   08 11   08 11   08 10   08 10   09 10   -2 -2   -1 -1   -1 -1   -1 -1   -1 -1   -1 -1   -1 -1   
-2 -2   -2 -2   -2 -2   -2 -2   -2 -2   -2 -2   -2 -2   -2 -2   07 10   08 10   09 10   -2 -2   -1 -1   -1 -1   -1 -1   -1 -1   -1 -1   -1 -1   
08 21   08 21   08 21   08 21   09 21   -1 -1   -1 -1   -2 -2   07 10   08 10   09 10   -2 -2   -1 -1   -1 -1   -1 -1   -1 -1   -1 -1   -1 -1   
08 22   08 22   08 22   08 22   09 22   -1 -1   -1 -1   -2 -2   07 10   08 10   09 10   -2 -2   -1 -1   -1 -1   -1 -1   -1 -1   -1 -1   -1 -1