-1 -1   -1 -1   -1 -1   -1 -1   -1 -1   -1 -1   -1 -1   00 05   -1 -1   -1 -1   00 05   -1 -1   -1 -1   -1 -1   -1 -1   -1 -1   -1 -1   -1 -1   
-1 -1   -1 -1   -1 -1   -1 -1   -1 -1   -1 -1   -1 -1   00 05   -1 -1   -1 -1   00 05   -1 -1   -1 -1   -1 -1   -1 -1   -1 -1   -1 -1   -1 -1      
-1 -1   -1 -1   -1 -1   -1 -1   -1 -1   -1 -1   -1 -1   00 05   -1 -1   -1 -1   00 05   -1 -1   -1 -1   -1 -1   -1 -1   -1 -1   -1 -1   -1 -1   
-1 -1   -1 -1   -1 -1   -1 -1   -1 -1   -1 -1   -1 -1   00 05   -1 -1   -1 -1   00 05   -1 -1   -1 -1   -1 -1   -1 -1   -1 -1   -1 -1   -1 -1    
00 05   00 05   00 05   00 05   00 05   00 05   00 05   00 05   -1 -1   16 05   00 05   00 05   00 05   00 05   00 05   00 05   00 05   00 05  
-1 -1   -1 -1   -1 -1   -1 -1   -1 -1   -1 -1   -1 -1   -1 -1   -1 -1   -1 -1   -1 -1   -1 -1   -1 -1   -1 -1   -1 -1   -1 -1   -1 -1   -1 -1   
-1 -1   -1 -1   -1 -1   -1 -1   -1 -1   -1 -1   -1 -1   -1 -1   -1 -1   -1 -1   -1 -1   -1 -1   -1 -1   -1 -1   -1 -1   -1 -1   -1 -1   -1 -1   
00 05   00 05   00 05   00 05   00 05   00 05   00 05   00 05   00 05   00 05   00 05   00 05   00 05   00 05   00 05   00 05   00 05   00 05  
-1 -1   -1 -1   -1 -1   -1 -1   -1 -1   -1 -1   -1 -1   -1 -1   -1 -1   -1 -1   -1 -1   -1 -1   -1 -1   -1 -1   -1 -1   -1 -1   -1 -1   -1 -1    
-1 -1   -1 -1   -1 -1   -1 -1   -1 -1   -1 -1   -1 -1   -1 -1   -1 -1   -1 -1   -1 -1   -1 -1   -1 -1   -1 -1   -1 -1   -1 -1   -1 -1   -1 -1   
