-1 -1   -1 -1   -1 -1   -1 -1   -1 -1   -1 -1   -1 -1   54 22   07 10   09 10   -2 -2   -1 -1   -1 -1   -1 -1   -1 -1   -1 -1   -1 -1   07 16   
-1 -1   56 22   -1 -1   -1 -1   -1 -1   -1 -1   -1 -1   -2 -2   07 10   09 10   -2 -2   -1 -1   -1 -1   -1 -1   -1 -1   -1 -1   -1 -1   07 16   
-1 -1   -1 -1   -1 -1   -1 -1   -1 -1   -1 -1   -1 -1   -2 -2   07 10   09 10   -2 -2   -1 -1   -1 -1   -1 -1   -1 -1   -1 -1   56 22   07 17   
-1 -1   -1 -1   -1 -1   -1 -1   55 22   -1 -1   -1 -1   -2 -2   07 10   09 10   -2 -2   -1 -1   -1 -1   -1 -1   -1 -1   -1 -1   -1 -1   -1 -1   
-2 -2   -2 -2   -2 -2   -2 -2   -2 -2   -2 -2   -2 -2   -2 -2   07 10   09 10   -2 -2   -2 -2   55 22   -2 -2   -2 -2   -2 -2   -2 -2   -2 -2 
08 09   08 09   08 09   08 09   08 09   08 09   08 09   08 09   08 10   08 10   08 09   08 09   08 09   08 09   08 09   08 09   08 09   08 09   
08 11   08 11   08 11   08 11   08 11   08 11   08 11   08 11   08 11   08 11   08 11   08 11   08 11   08 11   08 11   08 11   08 11   08 11   
-2 -2   -2 -2   -2 -2   -2 -2   -2 -2   -2 -2   -2 -2   -2 -2   -2 -2   -2 -2   -2 -2   -2 -2   -2 -2   -2 -2   -2 -2   -2 -2   -2 -2   -2 -2   
-1 -1   56 23   -1 -1   -1 -1   -1 -1   -1 -1   -1 -1   -1 -1   -1 -1   -1 -1   -1 -1   -1 -1   -1 -1   55 23   07 21   08 21   08 21   08 21   
-1 -1   -1 -1   -1 -1   -1 -1   -1 -1   -1 -1   -1 -1   -1 -1   54 23   -1 -1   -1 -1   -1 -1   -1 -1   -1 -1   07 22   08 22   08 22   08 22  
