00 05   00 05   00 05   00 05   00 05   00 05   00 05   00 05   00 05   00 05   00 05   00 05   00 05   00 05   00 05   00 05   00 05   00 05    
00 05   00 05   00 05   00 05   00 05   00 05   00 05   00 05   00 05   00 05   00 05   00 05   00 05   00 05   00 05   00 05   00 05   00 05   
00 05   00 05   00 05   00 05   00 05   00 05   00 05   00 05   00 05   00 05   00 05   00 05   00 05   00 05   00 05   00 05   00 05   00 05     
-1 -1   -1 -1   -1 -1   -1 -1   -1 -1   -1 -1   -1 -1   -1 -1   -1 -1   -1 -1   -1 -1   -1 -1   -1 -1   -1 -1   -1 -1   -1 -1   -1 -1   -1 -1   
-1 -1   -1 -1   37 09   -1 -1   29 18   -1 -1   -1 -1   -1 -1   -1 -1   -1 -1   -1 -1   -1 -1   -1 -1   -1 -1   -1 -1   -1 -1   -1 -1   -1 -1   
-1 -1   -1 -1   -1 -1   -1 -1   29 18   -1 -1   -1 -1   -1 -1   -1 -1   -1 -1   -1 -1   -1 -1   -1 -1   -1 -1   -1 -1   -1 -1   -1 -1   -1 -1   
-1 -1   -1 -1   -1 -1   -1 -1   -1 -1   -1 -1   -1 -1   -1 -1   -1 -1   -1 -1   -1 -1   -1 -1   -1 -1   -1 -1   -1 -1   -1 -1   -1 -1   -1 -1   
00 05   00 05   00 05   00 05   00 05   00 05   00 05   00 05   00 05   00 05   00 05   00 05   00 05   00 05   00 05   00 05   00 05   00 05    
00 05   00 05   00 05   00 05   00 05   00 05   00 05   00 05   00 05   00 05   00 05   00 05   00 05   00 05   00 05   00 05   00 05   00 05   
00 05   00 05   00 05   00 05   00 05   00 05   00 05   00 05   00 05   00 05   00 05   00 05   00 05   00 05   00 05   00 05   00 05   00 05   
