17 09   27 11   17 09   27 11   17 09   27 09   17 09   27 11   17 09   17 10   27 11   17 09   27 11   27 11   17 09   17 09   27 11   27 11   
27 11   17 09   27 11   27 11   27 11   17 09   27 11   17 09   27 11   17 11   17 09   27 11   17 09   17 09   27 11   17 09   27 11   27 11    
27 09   17 09   17 09   27 11   27 11   17 09   27 11   27 11   27 11   27 11   17 09   27 11   27 11   17 09   27 11   27 11   27 11   27 11   
08 16   08 16   08 16   08 16   08 16   08 16   08 16   08 16   08 16   08 16   08 16   08 16   08 16   08 16   08 16   08 16   08 16   08 16   
08 16   08 16   08 16   08 16   08 16   08 16   08 16   08 16   08 16   08 16   08 16   08 16   08 16   08 16   08 16   08 16   08 16   08 16   
08 16   08 16   08 16   08 16   08 16   08 16   08 16   08 16   08 16   08 16   08 16   08 16   08 16   08 16   08 16   08 16   08 16   08 16   
08 16   08 16   08 16   08 16   08 16   08 16   08 16   08 16   08 16   08 16   08 16   08 16   08 16   08 16   08 16   08 16   08 16   08 16   
17 09   27 11   27 09   27 11   27 11   17 09   27 11   27 11   27 11   17 09   27 11   27 11   27 09   17 09   27 11   27 11   17 09   27 11   
17 09   27 11   27 10   17 09   17 10   27 11   17 09   27 11   17 09   27 11   27 11   17 09   27 09   17 09   17 10   17 09   27 11   17 09   
27 11   17 09   27 10   27 11   17 11   17 09   27 11   17 09   27 11   27 11   17 09   17 09   27 10   27 11   17 11   17 09   27 11   27 11   
