38 16   39 16   39 16   39 16   39 16   39 16   39 16   39 16   39 16   39 16   39 16   39 16   39 16   39 16   39 16   39 16   39 16   40 16   
38 15   39 15   39 15   39 15   39 15   39 15   39 15   39 15   39 15   39 15   39 15   39 15   39 15   39 15   39 15   39 15   39 15   40 15  
35 15   34 15   34 15   34 15   34 15   34 15   34 15   34 15   34 15   34 15   34 15   34 15   34 15   34 15   34 15   34 15   34 15   37 15 
00 05   00 05   00 05   00 05   00 05   00 05   00 05   00 05   00 05   00 05   00 05   00 05   00 05   00 05   00 05   00 05   00 05   00 05   
00 05   00 05   00 05   00 05   00 05   00 05   00 05   00 05   00 05   00 05   00 05   00 05   00 05   00 05   00 05   00 05   00 05   00 05 
00 05   00 05   00 05   00 05   00 05   00 05   00 05   00 05   00 05   00 05   00 05   00 05   00 05   00 05   00 05   00 05   00 05   00 05   
00 05   00 05   00 05   00 05   00 05   00 05   00 05   00 05   00 05   00 05   00 05   00 05   00 05   00 05   00 05   00 05   00 05   00 05   
00 05   00 05   00 05   00 05   00 05   00 05   00 05   00 05   00 05   00 05   00 05   00 05   00 05   00 05   00 05   00 05   00 05   00 05   
00 05   00 05   00 05   00 05   00 05   00 05   00 05   00 05   00 05   00 05   00 05   00 05   00 05   00 05   00 05   00 05   00 05   00 05   
00 05   00 05   00 05   00 05   00 05   00 05   00 05   00 05   21 26   23 26   00 05   00 05   00 05   00 05   00 05   00 05   00 05   00 05   
