02 15   03 15   03 15   03 15   03 15   03 15   03 15   03 15   03 15   03 15   03 15   03 15   03 15   03 15   03 15   03 15   03 15   04 15   
02 16   03 16   03 16   03 16   03 16   03 16   03 16   03 16   03 16   03 16   03 16   03 16   03 16   03 16   03 16   03 16   03 16   04 16   
02 16   03 16   03 16   03 16   03 16   03 16   03 16   03 16   03 16   03 16   03 16   03 16   03 16   03 16   03 16   03 16   03 16   04 16   
02 16   03 16   03 16   03 16   03 16   03 16   03 16   03 16   03 16   03 16   03 16   03 16   03 16   03 16   03 16   03 16   03 16   04 16   
02 16   03 16   03 16   03 16   03 16   03 16   03 16   03 16   03 16   03 16   03 16   03 16   03 16   03 16   03 16   03 16   03 16   04 16   
02 16   03 16   03 16   03 16   03 16   03 16   03 16   03 16   03 16   03 16   03 16   03 16   03 16   03 16   03 16   03 16   03 16   04 16   
02 16   03 16   03 16   03 16   03 16   03 16   03 16   03 16   03 16   03 16   03 16   03 16   03 16   03 16   03 16   03 16   03 16   04 16   
02 16   03 16   03 16   03 16   03 16   03 16   03 16   03 16   03 16   03 16   03 16   03 16   03 16   03 16   03 16   03 16   03 16   04 16   
02 16   03 16   03 16   03 16   03 16   03 16   03 16   03 16   03 16   03 16   03 16   03 16   03 16   03 16   03 16   03 16   03 16   04 16   
02 17   03 17   03 17   03 17   03 17   03 17   03 17   03 17   03 17   03 17   03 17   03 17   03 17   03 17   03 17   03 17   03 17   04 17  
