-1 -1   -1 -1   -1 -1   -1 -1   -1 -1   -1 -1   -1 -1   -1 -1   -1 -1   -1 -1   -1 -1   -1 -1   -1 -1   -1 -1   -1 -1   -1 -1   -1 -1   -1 -1   
-1 -1   -1 -1   -1 -1   00 05   00 05   00 05   00 05   00 05   -1 -1   -1 -1   -1 -1   -1 -1   -1 -1   -1 -1   -1 -1   -1 -1   -1 -1   -1 -1   
-1 -1   -1 -1   -1 -1   00 05   -1 -1   -1 -1   -1 -1   00 05   -1 -1   -1 -1   49 22   -1 -1   -1 -1   -1 -1   -1 -1   -1 -1   -1 -1   -1 -1   
-1 -1   -1 -1   -1 -1   00 05   -1 -1   -1 -1   -1 -1   00 05   -1 -1   -1 -1   49 22   -1 -1   -1 -1   -1 -1   -1 -1   -1 -1   -1 -1   -1 -1   
-1 -1   -1 -1   -1 -1   52 00   41 02   -1 -1   41 02   00 05   -1 -1   -1 -1   53 22   -1 -1   -1 -1   -1 -1   -1 -1   -1 -1   -1 -1   -1 -1   
-1 -1   -1 -1   -1 -1   00 05   -1 -1   -1 -1   -1 -1   00 05   -1 -1   -1 -1   -1 -1   -1 -1   -1 -1   -1 -1   -1 -1   -1 -1   -1 -1   -1 -1   
-1 -1   -1 -1   -1 -1   00 05   00 05   32 04   00 05   00 05   -1 -1   -1 -1   -1 -1   -1 -1   -1 -1   -1 -1   -1 -1   -1 -1   -1 -1   -1 -1   
-1 -1   -1 -1   -1 -1   -1 -1   -1 -1   -1 -1   -1 -1   -1 -1   -1 -1   -1 -1   -1 -1   -1 -1   -1 -1   -1 -1   -1 -1   -1 -1   -1 -1   -1 -1   
-1 -1   -1 -1   -1 -1   -1 -1   -1 -1   -1 -1   -1 -1   -1 -1   -1 -1   -1 -1   -1 -1   -1 -1   -1 -1   -1 -1   -1 -1   -1 -1   -1 -1   -1 -1   
-1 -1   -1 -1   -1 -1   -1 -1   -1 -1   -1 -1   -1 -1   -1 -1   -1 -1   -1 -1   -1 -1   -1 -1   -1 -1   -1 -1   -1 -1   -1 -1   -1 -1   -1 -1   
