06 02   06 03   06 02   06 02   06 02   06 03   06 02   06 02   06 03   08 10   08 10   08 10   09 10   00 00   00 00   00 00   00 00   00 00   
06 03   06 02   06 02   27 21   32 21   32 21   32 21   28 21   06 03   08 10   08 10   08 10   09 10   00 00   00 00   00 00   00 00   00 00   
06 02   06 03   06 02   27 22   32 22   32 22   32 22   28 22   06 03   08 10   08 10   08 10   09 10   00 00   00 00   00 00   00 00   00 00   
06 03   06 03   06 02   27 23   29 22   29 22   29 22   28 23   06 03   08 10   08 10   08 10   09 10   00 00   00 00   00 00   00 00   00 00   
06 03   06 02   06 02   31 21   32 21   32 21   32 21   33 21   06 03   08 10   08 10   08 10   09 10   00 00   00 00   00 00   00 00   00 00   
06 02   06 03   06 02   31 22   32 22   32 22   32 22   33 22   06 03   08 10   08 10   08 10   09 10   00 00   00 00   00 00   00 00   00 00   
06 02   06 03   06 02   31 23   32 23   32 23   32 23   33 23   06 03   08 10   08 10   08 10   09 10   00 00   00 00   00 00   00 00   00 00   
06 02   06 03   06 02   06 02   06 02   06 03   06 02   06 02   06 03   08 10   08 10   08 10   09 10   00 00   00 00   00 00   00 00   00 00   
06 02   06 02   06 03   06 02   06 03   06 02   06 03   06 02   06 02   08 10   08 10   08 10   09 10   00 00   00 00   00 00   00 00   00 00   
06 02   06 03   06 02   06 02   06 02   06 03   06 02   06 02   06 03   08 10   08 10   08 10   09 10   00 00   00 00   00 00   00 00   00 00   
