08 10   08 10   08 10   06 02   06 02   06 03   06 02   06 02   08 10   08 10   08 10   08 10   00 00   00 00   00 00   00 00   00 00   00 00   
08 10   08 10   08 10   06 02   06 02   06 03   06 02   06 02   08 10   08 10   08 10   08 10   00 00   00 00   00 00   00 00   00 00   00 00   
08 10   08 10   08 10   06 02   06 02   06 03   06 02   06 02   08 10   08 10   08 10   08 10   00 00   00 00   00 00   00 00   00 00   00 00   
08 10   08 10   08 10   32 23   32 23   32 23   32 23   32 23   08 10   08 10   08 10   08 10   00 00   00 00   00 00   00 00   00 00   00 00   
08 10   08 10   08 10   08 10   08 10   08 10   08 10   08 10   08 10   08 10   08 10   08 10   00 00   00 00   00 00   00 00   00 00   00 00   
08 10   08 10   08 10   08 10   08 10   08 10   08 10   08 10   08 10   08 10   08 10   08 10   00 00   00 00   00 00   00 00   00 00   00 00   
08 10   08 10   08 10   08 10   08 10   08 10   08 10   08 10   08 10   08 10   08 10   08 10   00 00   00 00   00 00   00 00   00 00   00 00   
08 10   08 10   08 10   08 10   08 10   08 10   08 10   08 10   08 10   08 10   08 10   08 10   00 00   00 00   00 00   00 00   00 00   00 00   
08 10   08 10   08 10   08 10   08 10   08 10   08 10   08 10   08 10   08 10   08 10   08 10   00 00   00 00   00 00   00 00   00 00   00 00   
08 10   08 10   08 10   08 10   08 10   08 10   08 10   08 10   08 10   08 10   08 10   08 10   00 00   00 00   00 00   00 00   00 00   00 00   
