   -1 -1   -1 -1   42 15   44 15   -1 -1   -1 -1   -1 -1   -1 -1   -1 -1   -1 -1   -1 -1   -1 -1    -1 -1   -1 -1   46 14   50 14   -1 -1   -1 -1
   -1 -1   -1 -1   -1 -1   -1 -1   -1 -1   -1 -1   -1 -1   -1 -1   -1 -1   -1 -1   -1 -1   -1 -1    -1 -1   -1 -1   -1 -1   -1 -1   -1 -1   -1 -1
   -1 -1   -1 -1   -1 -1   -1 -1   -1 -1   00 05   00 05   55 12   41 15   00 05   00 05   46 15    00 05   -1 -1   -1 -1   -1 -1   -1 -1   -1 -1
   -1 -1   -1 -1   -1 -1   -1 -1   -1 -1   00 05   00 05   00 05   00 05   00 05   00 05   00 05    00 05   -1 -1   -1 -1   -1 -1   -1 -1   -1 -1
   -1 -1   -1 -1   -1 -1   -1 -1   -1 -1   -1 -1   -1 -1   -1 -1   -1 -1   -1 -1   -1 -1   -1 -1    -1 -1   -1 -1   -1 -1   -1 -1   -1 -1   -1 -1
   -1 -1   -1 -1   13 07   14 07   13 07   -1 -1   -1 -1   -1 -1   -1 -1   -1 -1   -1 -1   -1 -1    -1 -1   14 07   13 07   14 07   -1 -1   -1 -1
   -1 -1   -1 -1   00 05   00 05   00 05   -1 -1   -1 -1   -1 -1   -1 -1   -1 -1   -1 -1   -1 -1    -1 -1   00 05   00 05   00 05   -1 -1   -1 -1
   -1 -1   -1 -1   14 07   13 07   14 07   -1 -1   -1 -1   -1 -1   -1 -1   -1 -1   -1 -1   -1 -1    -1 -1   13 07   14 07   13 07   -1 -1   -1 -1
   -1 -1   -1 -1   -1 -1   -1 -1   -1 -1   -1 -1   -1 -1   -1 -1   -1 -1   -1 -1   -1 -1   -1 -1    -1 -1   -1 -1   -1 -1   -1 -1   -1 -1   -1 -1
   -1 -1   26 04   27 04   27 04   27 04   27 06   -1 -1   -1 -1   -1 -1   -1 -1   -1 -1   -1 -1    26 04   27 04   27 04   27 04   27 06   -1 -1