   -1 -1   -1 -1   -1 -1   -1 -1   -1 -1   34 17   35 17   35 17   35 17   35 17   35 17   36 17   -1 -1   -1 -1   -1 -1   -1 -1   -1 -1   -1 -1
   -1 -1   -1 -1   -1 -1   -1 -1   -1 -1   34 17   -1 -1   -1 -1   -1 -1   -1 -1   -1 -1   36 17   -1 -1   -1 -1   -1 -1   -1 -1   -1 -1   -1 -1
   -1 -1   -1 -1   -1 -1   -1 -1   -1 -1   34 17   -1 -1   -1 -1   -1 -1   -1 -1   -1 -1   36 17   -1 -1   -1 -1   -1 -1   -1 -1   -1 -1   -1 -1
   -1 -1   -1 -1   -1 -1   -1 -1   -1 -1   34 17   -1 -1   -1 -1   -1 -1   -1 -1   -1 -1   36 17   -1 -1   -1 -1   -1 -1   -1 -1   -1 -1   -1 -1
   -1 -1   -1 -1   -1 -1   -1 -1   -1 -1   34 17   -1 -1   -1 -1   -1 -1   -1 -1   -1 -1   36 17   -1 -1   -1 -1   -1 -1   -1 -1   -1 -1   -1 -1
   -1 -1   -1 -1   -1 -1   -1 -1   -1 -1   34 17   -1 -1   -1 -1   -1 -1   -1 -1   -1 -1   36 17   -1 -1   -1 -1   -1 -1   -1 -1   -1 -1   -1 -1
   -1 -1   -1 -1   -1 -1   -1 -1   -1 -1   34 17   35 17   -1 -1   -1 -1   -1 -1   35 17   36 17   -1 -1   -1 -1   -1 -1   -1 -1   -1 -1   -1 -1
   -1 -1   -1 -1   -1 -1   -1 -1   -1 -1   -1 -1   34 17   -1 -1   -1 -1   -1 -1   36 17   -1 -1   -1 -1   -1 -1   -1 -1   -1 -1   -1 -1   -1 -1
   -1 -1   -1 -1   -1 -1   -1 -1   -1 -1   -1 -1   34 17   -1 -1   -1 -1   -1 -1   36 17   -1 -1   -1 -1   -1 -1   -1 -1   -1 -1   -1 -1   -1 -1
   -1 -1   -1 -1   -1 -1   -1 -1   -1 -1   -1 -1   34 17   35 17   -1 -1   35 17   36 17   -1 -1   -1 -1   -1 -1   -1 -1   -1 -1   -1 -1   -1 -1