00 05   00 05   16 03   16 03   00 05   00 05   00 05   00 05   00 05   00 05   00 05   00 05   00 05   00 05   00 05   00 05   00 05   00 05
00 05   00 05   00 05   00 05   00 05   00 05   00 05   00 05   00 05   00 05   00 05   00 05   00 05   00 05   00 05   00 05   00 05   00 05
00 05   00 05   00 05   00 05   00 05   31 16   32 16   32 16   32 16   32 16   32 16   32 16   33 16   00 05   00 05   00 05   00 05   00 05
00 05   00 05   00 05   00 05   00 05   28 15   27 15   27 15   27 15   27 15   27 15   27 15   30 15   00 05   00 05   00 05   00 05   00 05
00 05   00 05   00 05   00 05   00 05   00 05   00 05   00 05   10 17   12 17   00 05   00 05   00 05   00 05   00 05   00 05   00 05   00 05
00 05   00 05   00 05   00 05   00 05   00 05   00 05   00 05   10 17   12 17   00 05   00 05   00 05   00 05   00 05   00 05   00 05   00 05
00 05   00 05   19 06   21 06   20 06   00 05   00 05   00 05   10 17   12 17   00 05   00 05   00 05   19 06   21 06   20 06   00 05   00 05
00 05   00 05   00 05   00 05   00 05   00 05   00 05   00 05   10 17   12 17   00 05   00 05   00 05   00 05   00 05   00 05   00 05   00 05
00 05   00 05   00 05   00 05   00 05   00 05   00 05   00 05   10 17   12 17   00 05   00 05   00 05   00 05   00 05   00 05   00 05   00 05
00 05   00 05   00 05   00 05   00 05   00 05   00 05   00 05   10 17   12 17   00 05   00 05   00 05   00 05   00 05   00 05   00 05   00 05