-1 -1   -1 -1   16 03   16 03   -1 -1   -1 -1   -1 -1   -1 -1   -1 -1   -1 -1   -1 -1   -1 -1   -1 -1   -1 -1   -1 -1   -1 -1   -1 -1   -1 -1
-1 -1   -1 -1   -1 -1   -1 -1   -1 -1   -1 -1   -1 -1   -1 -1   -1 -1   -1 -1   -1 -1   -1 -1   -1 -1   -1 -1   -1 -1   -1 -1   -1 -1   -1 -1
-1 -1   -1 -1   -1 -1   -1 -1   -1 -1   31 16   32 16   32 16   32 16   32 16   32 16   32 16   33 16   -1 -1   -1 -1   -1 -1   -1 -1   -1 -1
-1 -1   -1 -1   -1 -1   -1 -1   -1 -1   28 15   27 15   27 15   27 15   27 15   27 15   27 15   30 15   -1 -1   -1 -1   -1 -1   -1 -1   -1 -1
-1 -1   -1 -1   -1 -1   -1 -1   -1 -1   -1 -1   -1 -1   -1 -1   10 17   12 17   -1 -1   -1 -1   -1 -1   -1 -1   -1 -1   -1 -1   -1 -1   -1 -1
-1 -1   -1 -1   -1 -1   -1 -1   -1 -1   -1 -1   -1 -1   -1 -1   10 17   12 17   -1 -1   -1 -1   -1 -1   -1 -1   -1 -1   -1 -1   -1 -1   -1 -1
-1 -1   -1 -1   19 06   21 06   20 06   -1 -1   -1 -1   -1 -1   10 17   12 17   -1 -1   -1 -1   -1 -1   19 06   21 06   20 06   -1 -1   -1 -1
-1 -1   -1 -1   -1 -1   -1 -1   -1 -1   -1 -1   -1 -1   -1 -1   10 17   12 17   -1 -1   -1 -1   -1 -1   -1 -1   -1 -1   -1 -1   -1 -1   -1 -1
-1 -1   -1 -1   -1 -1   -1 -1   -1 -1   -1 -1   -1 -1   -1 -1   10 17   12 17   -1 -1   -1 -1   -1 -1   -1 -1   -1 -1   -1 -1   -1 -1   -1 -1
-1 -1   -1 -1   -1 -1   -1 -1   -1 -1   -1 -1   -1 -1   -1 -1   10 17   12 17   -1 -1   -1 -1   -1 -1   -1 -1   -1 -1   -1 -1   -1 -1   -1 -1