27 09  27 09  27 09  27 09  -1 -1  00 05  00 05  00 05  -1 -1  -1 -1  -1 -1  00 05  -1 -1  -1 -1  -1 -1  -1 -1  -1 -1  -1 -1
27 09  17 09  27 10  27 09  -1 -1  00 05  00 05  00 05  -1 -1  -1 -1  -1 -1  00 05  -1 -1  -1 -1  -1 -1  -1 -1  -1 -1  -1 -1
27 09  27 09  27 11  27 09  -1 -1  00 05  00 05  00 05  -1 -1  -1 -1  -1 -1  00 05  -1 -1  -1 -1  -1 -1  -1 -1  -1 -1  -1 -1
17 09  27 09  17 09  17 09  -1 -1  00 05  00 05  00 05  -1 -1  -1 -1  -1 -1  00 05  -1 -1  -1 -1  -1 -1  -1 -1  -1 -1  -1 -1
-1 -1  -1 -1  -1 -1  -1 -1  -1 -1  -1 -1  00 05  -1 -1  -1 -1  -1 -1  -1 -1  00 05  -1 -1  -1 -1  -1 -1  -1 -1  -1 -1  -1 -1
-1 -1  -1 -1  -1 -1  -1 -1  -1 -1  -1 -1  00 05  -1 -1  -1 -1  -1 -1  -1 -1  00 05  -1 -1  -1 -1  -1 -1  -1 -1  -1 -1  -1 -1
17 09  27 09  27 09  27 09  -1 -1  00 05  00 05  00 05  -1 -1  -1 -1  -1 -1  00 05  -1 -1  -1 -1  -1 -1  -1 -1  -1 -1  -1 -1
27 11  17 09  27 10  27 09  -1 -1  00 05  00 05  00 05  -1 -1  -1 -1  -1 -1  00 05  -1 -1  -1 -1  -1 -1  -1 -1  -1 -1  -1 -1
27 09  27 09  27 11  17 09  -1 -1  00 05  00 05  00 05  -1 -1  -1 -1  -1 -1  00 05  -1 -1  -1 -1  -1 -1  -1 -1  -1 -1  -1 -1
17 09  27 09  27 09  27 09  -1 -1  00 05  00 05  00 05  -1 -1  -1 -1  -1 -1  00 05  -1 -1  -1 -1  -1 -1  -1 -1  -1 -1  -1 -1