27 11  27 11  27 09  27 11  -1 -1  00 05  00 05  00 05  -1 -1  -1 -1  -1 -1  00 05  -1 -1  -1 -1  -1 -1  -1 -1  -1 -1  -1 -1
27 11  17 09  27 10  27 11  -1 -1  00 05  00 05  00 05  -1 -1  -1 -1  -1 -1  00 05  -1 -1  -1 -1  -1 -1  -1 -1  -1 -1  -1 -1
27 11  27 11  27 11  27 11  -1 -1  00 05  00 05  00 05  -1 -1  -1 -1  -1 -1  00 05  -1 -1  -1 -1  -1 -1  -1 -1  -1 -1  -1 -1
-1 -1  -1 -1  -1 -1  -1 -1  -1 -1  00 05  00 05  00 05  -1 -1  -1 -1  -1 -1  00 05  -1 -1  56 23  -1 -1  54 23  -1 -1  -1 -1
-1 -1  -1 -1  -1 -1  -1 -1  -1 -1  -1 -1  -1 -1  -1 -1  -1 -1  -1 -1  -1 -1  00 05  -1 -1  -1 -1  -1 -1  -1 -1  -1 -1  -1 -1
-1 -1  -1 -1  -1 -1  -1 -1  -1 -1  -1 -1  -1 -1  -1 -1  -1 -1  -1 -1  -1 -1  00 05  -1 -1  -1 -1  -1 -1  -1 -1  -1 -1  -1 -1
-1 -1  -1 -1  -1 -1  -1 -1  -1 -1  00 05  00 05  00 05  -1 -1  -1 -1  -1 -1  00 05  -1 -1  -1 -1  -1 -1  -1 -1  54 24  -1 -1
27 11  17 09  17 09  27 11  -1 -1  00 05  00 05  00 05  -1 -1  -1 -1  -1 -1  00 05  -1 -1  -1 -1  -1 -1  -1 -1  -1 -1  -1 -1
27 11  27 11  27 11  17 09  -1 -1  00 05  00 05  00 05  -1 -1  -1 -1  -1 -1  00 05  -1 -1  -1 -1  56 24  -1 -1  -1 -1  -1 -1
17 09  27 11  27 11  27 11  -1 -1  00 05  00 05  00 05  -1 -1  -1 -1  -1 -1  00 05  -1 -1  -1 -1  -1 -1  -1 -1  -1 -1  -1 -1