08 16   08 16   08 16   08 16   09 16   -2 -2   -1 -1   -2 -2   07 10   08 10   09 10   -2 -2   -1 -1   -1 -1   -1 -1   -1 -1   -1 -1   -1 -1 
08 16   08 16   08 16   08 16   09 16   -2 -2   -1 -1   -2 -2   07 10   08 10   09 10   -2 -2   -1 -1   -1 -1   -1 -1   -1 -1   -1 -1   -1 -1
08 16   08 16   08 16   08 16   09 16   -2 -2   -1 -1   -2 -2   07 10   08 10   09 10   -2 -2   -1 -1   -1 -1   -1 -1   -1 -1   -1 -1   -1 -1    
08 16   08 16   08 16   08 16   09 16   -2 -2   -2 -2   -2 -2   07 10   08 10   09 10   -2 -2   -1 -1   -1 -1   -1 -1   -1 -1   -1 -1   -1 -1
08 16   08 16   08 16   08 16   08 16   09 15   -1 -1   07 09   08 10   08 10   09 10   -2 -2   -1 -1   -1 -1   -1 -1   -1 -1   -1 -1   -1 -1 
08 16   08 16   08 16   08 16   08 16   09 17   -1 -1   07 11   08 10   08 10   09 10   -2 -2   -1 -1   -1 -1   -1 -1   -1 -1   -1 -1   -1 -1   
08 16   08 16   08 16   08 16   09 16   -2 -2   -2 -2   -2 -2   07 10   08 10   09 10   -2 -2   -1 -1   -1 -1   -1 -1   -1 -1   -1 -1   -1 -1   
08 16   08 16   08 16   08 16   09 16   -2 -2   -1 -1   -2 -2   07 10   08 10   09 10   -2 -2   -1 -1   -1 -1   -1 -1   -1 -1   -1 -1   -1 -1   
08 16   08 16   08 16   08 16   09 16   -2 -2   -1 -1   -2 -2   07 10   08 10   09 10   -2 -2   -1 -1   -1 -1   -1 -1   -1 -1   -1 -1   -1 -1   
08 16   08 16   08 16   08 16   09 16   -2 -2   -1 -1   -2 -2   07 10   08 10   09 10   -2 -2   -1 -1   -1 -1   -1 -1   -1 -1   -1 -1   -1 -1