-1 -1   -1 -1   -1 -1   -1 -1   -1 -1   -1 -1   -1 -1   -1 -1   -1 -1   -1 -1   -1 -1   -1 -1   -1 -1   -1 -1   -1 -1   -1 -1   -1 -1   -1 -1   
-1 -1   -1 -1   -1 -1   -1 -1   00 05   00 05   00 05   00 05   00 05   00 05   00 05   00 05   -1 -1   -1 -1   -1 -1   -1 -1   -1 -1   -1 -1      
-1 -1   -1 -1   -1 -1   -1 -1   00 05   -1 -1   -1 -1   50 10   -1 -1   -1 -1   -1 -1   00 05   -1 -1   -1 -1   -1 -1   -1 -1   -1 -1   -1 -1   
-1 -1   -1 -1   -1 -1   -1 -1   00 05   -1 -1   -1 -1   50 11   -1 -1   27 09   -1 -1   00 05   -1 -1   -1 -1   -1 -1   -1 -1   -1 -1   -1 -1    
-1 -1   -1 -1   -1 -1   -1 -1   00 05   -1 -1   -1 -1   36 02   -1 -1   27 10   -1 -1   00 05   -1 -1   -1 -1   -1 -1   -1 -1   -1 -1   -1 -1  
-1 -1   -1 -1   -1 -1   -1 -1   00 05   -1 -1   -1 -1   -1 -1   -1 -1   53 21   -1 -1   00 05   -1 -1   -1 -1   -1 -1   -1 -1   -1 -1   -1 -1   
-1 -1   -1 -1   -1 -1   -1 -1   00 05   -1 -1   -1 -1   -1 -1   -1 -1   -1 -1   -1 -1   00 05   -1 -1   -1 -1   -1 -1   -1 -1   -1 -1   -1 -1   
-1 -1   -1 -1   -1 -1   -1 -1   00 05   00 05   00 05   -1 -1   -1 -1   00 05   00 05   00 05   -1 -1   -1 -1   -1 -1   -1 -1   -1 -1   -1 -1  
-1 -1   -1 -1   -1 -1   -1 -1   -1 -1   -1 -1   00 05   -1 -1   -1 -1   00 05   -1 -1   -1 -1   -1 -1   -1 -1   -1 -1   -1 -1   -1 -1   -1 -1    
-1 -1   -1 -1   -1 -1   -1 -1   -1 -1   -1 -1   00 05   -1 -1   -1 -1   00 05   -1 -1   -1 -1   -1 -1   -1 -1   -1 -1   -1 -1   -1 -1   -1 -1   
