-1 -1   -1 -1   -1 -1   -1 -1   -1 -1   -1 -1   -1 -1   -1 -1   -1 -1   -1 -1   -1 -1   -1 -1   -1 -1   -1 -1   -1 -1   -1 -1   -1 -1   07 16   
-1 -1   -1 -1   -1 -1   -1 -1   -2 -2   -2 -2   -2 -2   -2 -2   -2 -2   -2 -2   -2 -2   -2 -2   -1 -1   -1 -1   -1 -1   -1 -1   -1 -1   07 16      
-1 -1   -1 -1   -1 -1   -1 -1   -2 -2   07 09   08 09   08 09   08 09   08 09   09 09   -2 -2   -1 -1   -1 -1   -1 -1   -1 -1   -1 -1   07 16  
-1 -1   -1 -1   -1 -1   -1 -1   -2 -2   07 10   08 10   08 10   08 10   08 10   09 10   -2 -2   -1 -1   -1 -1   -1 -1   -1 -1   -1 -1   07 16    
-1 -1   -1 -1   -1 -1   -1 -1   -2 -2   07 10   08 10   08 10   08 10   08 10   09 10   -2 -2   -1 -1   -1 -1   -1 -1   -1 -1   -1 -1   07 16  
-1 -1   -1 -1   -1 -1   -1 -1   -2 -2   07 10   08 10   08 10   08 10   08 10   09 10   -2 -2   -1 -1   -1 -1   -1 -1   -1 -1   -1 -1   07 16   
-1 -1   -1 -1   -1 -1   -1 -1   -2 -2   07 11   08 11   08 10   08 10   08 11   09 11   -2 -2   -1 -1   -1 -1   -1 -1   -1 -1   -1 -1   07 16   
-1 -1   -1 -1   -1 -1   -1 -1   -2 -2   -2 -2   -2 -2   07 10   09 10   -2 -2   -2 -2   -2 -2   -1 -1   -1 -1   -1 -1   -1 -1   -1 -1   07 16  
-1 -1   -1 -1   -1 -1   -1 -1   -1 -1   -1 -1   -2 -2   07 10   09 10   -2 -2   -1 -1   -1 -1   -1 -1   -1 -1   -1 -1   -1 -1   -1 -1   07 16    
-1 -1   -1 -1   -1 -1   -1 -1   -1 -1   -1 -1   -2 -2   07 10   09 10   -2 -2   -1 -1   -1 -1   -1 -1   -1 -1   -1 -1   -1 -1   -1 -1   07 16   
