06 03   06 03   06 02   06 02   06 02   06 03   06 02   06 02   06 03   06 02   06 02   06 02   06 02   06 03   06 02   06 03   06 02   06 02   
06 03   06 02   13 21   18 21   18 21   18 21   14 21   06 03   06 02   34 21   39 21   39 21   39 21   35 21   06 02   06 02   06 03   06 03   
06 03   06 02   13 22   18 22   18 22   18 22   14 22   06 02   06 02   34 22   39 22   39 22   39 22   35 22   06 03   06 02   06 02   06 02   
06 03   06 03   13 23   15 22   15 22   15 22   14 23   06 02   06 03   34 23   36 22   36 22   36 22   35 23   06 02   06 02   06 03   06 03   
06 03   06 02   17 21   18 21   18 21   18 21   19 21   06 03   06 02   38 21   39 21   39 21   39 21   40 21   06 03   06 02   06 03   06 02   
06 02   06 03   17 22   18 22   18 22   18 22   19 22   06 02   06 03   38 22   39 22   39 22   39 22   40 22   06 02   06 03   06 03   06 03   
06 02   06 02   17 23   18 23   18 23   18 23   19 23   06 03   06 02   38 23   39 23   39 23   39 23   40 23   06 03   06 02   06 02   06 02   
06 02   06 03   06 02   06 02   06 02   06 03   06 02   06 02   06 03   06 02   06 02   06 02   06 02   06 03   06 02   06 03   06 02   06 02   
06 02   06 02   06 03   06 02   06 03   06 02   06 03   06 02   06 02   06 02   06 02   06 03   06 02   06 02   06 03   06 02   06 03   06 02   
06 02   06 03   06 02   06 02   06 02   06 03   06 02   06 02   06 03   06 02   06 02   06 02   06 02   06 03   06 02   06 03   06 02   06 02   
