08 16   08 16   08 16   08 16   09 16   -2 -2   -1 -1   -2 -2   07 10   08 10   09 10   -2 -2   -1 -1   -1 -1   -1 -1   -1 -1   -1 -1   -1 -1 
08 16   08 16   08 16   08 16   09 16   -2 -2   -1 -1   -2 -2   07 10   08 10   09 10   -2 -2   -1 -1   -1 -1   -1 -1   -1 -1   -1 -1   -1 -1
08 16   08 16   08 16   08 16   09 16   -2 -2   -1 -1   -2 -2   07 10   08 10   09 10   -2 -2   -1 -1   -1 -1   -1 -1   -1 -1   -1 -1   -1 -1    
08 16   08 16   08 16   08 16   09 16   -2 -2   -1 -1   -2 -2   07 10   08 10   09 10   -2 -2   -1 -1   -1 -1   -1 -1   -1 -1   -1 -1   -1 -1
08 16   08 16   08 16   08 16   09 16   -2 -2   -1 -1   -2 -2   07 10   08 10   09 10   -2 -2   -1 -1   -1 -1   -1 -1   -1 -1   -1 -1   -1 -1 
08 16   08 16   08 16   08 16   09 16   -2 -2   -1 -1   -2 -2   07 10   08 10   09 10   -2 -2   -1 -1   -1 -1   -1 -1   -1 -1   -1 -1   -1 -1   
08 16   08 16   08 16   08 16   09 16   -2 -2   -1 -1   -2 -2   07 10   08 10   09 10   -2 -2   -1 -1   -1 -1   -1 -1   -1 -1   -1 -1   -1 -1   
08 16   08 16   08 16   08 16   09 16   -2 -2   -1 -1   -2 -2   07 10   08 10   09 10   -2 -2   -1 -1   -1 -1   -1 -1   -1 -1   -1 -1   -1 -1   
08 16   08 16   08 16   08 16   09 16   -2 -2   -1 -1   -2 -2   07 10   08 10   09 10   -2 -2   -1 -1   -1 -1   -1 -1   -1 -1   -1 -1   -1 -1   
08 16   08 16   08 16   08 16   09 16   -2 -2   -1 -1   -2 -2   07 10   08 10   09 10   -2 -2   -1 -1   -1 -1   -1 -1   -1 -1   -1 -1   -1 -1