08 22   08 22   08 22   08 22   09 22   -2 -2   -1 -1   -2 -2   07 10   08 10   09 10   -2 -2   -1 -1   -1 -1   -1 -1   -1 -1   -1 -1   -1 -1 
08 22   08 22   08 22   08 22   09 22   -2 -2   -2 -2   -2 -2   07 10   08 10   09 10   -2 -2   -1 -1   -1 -1   -1 -1   -1 -1   -1 -1   -1 -1
08 22   08 22   08 22   08 22   08 22   53 13   53 13   53 13   08 10   08 10   09 10   -2 -2   -1 -1   -1 -1   -1 -1   -1 -1   -1 -1   -1 -1    
08 22   08 22   08 22   08 22   09 22   -2 -2   -2 -2   -2 -2   07 10   08 10   09 10   -2 -2   -1 -1   -1 -1   -1 -1   -1 -1   -1 -1   -1 -1
08 22   08 22   08 22   08 22   09 22   -2 -2   -1 -1   -2 -2   07 11   08 11   09 11   -2 -2   -1 -1   -1 -1   -1 -1   -1 -1   -1 -1   -1 -1 
08 23   08 23   08 23   08 23   09 23   -2 -2   -1 -1   -2 -2   -2 -2   -2 -2   -2 -2   -2 -2   -1 -1   -1 -1   -1 -1   -1 -1   -1 -1   -1 -1   
-2 -2   -2 -2   -2 -2   -2 -2   -2 -2   -2 -2   -1 -1   -1 -1   -1 -1   -1 -1   -1 -1   -1 -1   -1 -1   -1 -1   -1 -1   -1 -1   -1 -1   -1 -1
-1 -1   -1 -1   -1 -1   -1 -1   -1 -1   -1 -1   -1 -1   -1 -1   -1 -1   -1 -1   -1 -1   -1 -1   -1 -1   -1 -1   -1 -1   -1 -1   -1 -1   -1 -1
-1 -1   -1 -1   -1 -1   -1 -1   -1 -1   -1 -1   -1 -1   -1 -1   -1 -1   -1 -1   -1 -1   -1 -1   -1 -1   -1 -1   -1 -1   -1 -1   -1 -1   -1 -1
-1 -1   -1 -1   -1 -1   -1 -1   -1 -1   -1 -1   -1 -1   -1 -1   -1 -1   -1 -1   -1 -1   -1 -1   -1 -1   -1 -1   -1 -1   -1 -1   -1 -1   -1 -1