-1 -1   -1 -1   -1 -1   -2 -2   07 10   08 10   08 10   09 10   -2 -2   -1 -1   -1 -1   -1 -1   -1 -1   -1 -1   -1 -1   -1 -1   -1 -1   -1 -1
-1 -1   -1 -1   -1 -1   -2 -2   07 10   08 10   08 10   09 10   -2 -2   -1 -1   -1 -1   -1 -1   -1 -1   -1 -1   -1 -1   -1 -1   -1 -1   -1 -1
-1 -1   -1 -1   -1 -1   -2 -2   07 10   08 10   08 10   09 10   -2 -2   -2 -2   -2 -2   -2 -2   -2 -2   -2 -2   -1 -1   -1 -1   -1 -1   -1 -1
-1 -1   -1 -1   -1 -1   -2 -2   07 10   08 10   08 10   08 10   53 13   53 13   53 13   53 13   53 14   -2 -2   -1 -1   -1 -1   -1 -1   -1 -1
-1 -1   -1 -1   -1 -1   -2 -2   07 10   08 10   08 10   09 10   -2 -2   53 15   -1 -1   53 15   -1 -1   -2 -2   -1 -1   -1 -1   -1 -1   -1 -1
-1 -1   -1 -1   -1 -1   -2 -2   07 10   08 10   08 10   09 10   -2 -2   -1 -1   -1 -1   53 18   -1 -1   -2 -2   -1 -1   -1 -1   -1 -1   -1 -1
-1 -1   -1 -1   -1 -1   -2 -2   07 10   08 10   08 10   08 10   53 13   53 13   53 13   53 13   53 14   -2 -2   -1 -1   -1 -1   -1 -1   -1 -1
-1 -1   -1 -1   -1 -1   -2 -2   07 11   08 11   08 11   09 11   -2 -2   -2 -2   -2 -2   -2 -2   -2 -2   -2 -2   -1 -1   -1 -1   -1 -1   -1 -1
-1 -1   -1 -1   -1 -1   -2 -2   -2 -2   -2 -2   -2 -2   -2 -2   -2 -2   -1 -1   -1 -1   -1 -1   -1 -1   -1 -1   -1 -1   -1 -1   -1 -1   -1 -1
-1 -1   -1 -1   -1 -1   -1 -1   -1 -1   -1 -1   -1 -1   -1 -1   -1 -1   -1 -1   -1 -1   -1 -1   -1 -1   -1 -1   -1 -1   -1 -1   -1 -1   -1 -1