08 16   08 16   08 16   08 16   08 16   08 16   08 16   08 16   08 16   08 16   08 16   08 16   08 16   08 16   08 16   08 16   08 16   08 16 
08 16   08 16   08 16   08 16   08 16   08 16   08 16   08 16   08 16   08 16   08 16   08 16   08 16   08 16   08 16   08 16   08 16   08 16   
08 17   08 17   08 17   08 17   08 17   08 17   08 17   08 17   08 17   08 17   08 17   08 17   08 17   08 17   08 17   08 17   08 17   08 17   
-1 -1   -1 -1   -1 -1   -1 -1   -1 -1   -1 -1   -1 -1   -1 -1   -1 -1   -1 -1   -1 -1   -1 -1   -1 -1   -1 -1   -1 -1   -1 -1   -1 -1   -1 -1
-2 -2   -2 -2   -2 -2   -2 -2   -2 -2   -2 -2   -2 -2   -2 -2   -2 -2   -2 -2   -2 -2   -2 -2   -2 -2   -2 -2   -2 -2   -2 -2   -2 -2   -2 -2 
08 09   08 09   08 09   08 09   08 09   08 09   08 09   08 09   08 09   08 09   08 09   08 09   08 09   08 09   08 09   08 09   08 09   08 09   
08 11   08 11   08 11   08 11   08 11   08 11   08 11   08 11   08 11   08 11   08 11   08 11   08 11   08 11   08 11   08 11   08 11   08 11   
-2 -2   -2 -2   -2 -2   -2 -2   -2 -2   -2 -2   -2 -2   -2 -2   -2 -2   -2 -2   -2 -2   -2 -2   -2 -2   -2 -2   -2 -2   -2 -2   -2 -2   -2 -2   
08 21   08 21   08 21   08 21   08 21   08 21   08 21   08 21   08 21   08 21   08 21   08 21   08 21   08 21   08 21   08 21   08 21   08 21   
08 22   08 22   08 22   08 22   08 22   08 22   08 22   08 22   08 22   08 22   08 22   08 22   08 22   08 22   08 22   08 22   08 22   08 22