08 09   08 09   09 09   -2 -2   -1 -1   -1 -1   -1 -1   20 21   25 21   21 21   -1 -1   -1 -1   -1 -1   -1 -1   -1 -1   -1 -1   -1 -1   -1 -1
08 11   08 10   09 10   -2 -2   -1 -1   -1 -1   -1 -1   20 22   25 22   21 22   -1 -1   -1 -1   -1 -1   -1 -1   -1 -1   -1 -1   -1 -1   -1 -1
-2 -2   07 10   09 10   -2 -2   -1 -1   -1 -1   -1 -1   20 23   22 22   21 23   -1 -1   -1 -1   -1 -1   -1 -1   -1 -1   -1 -1   -1 -1   -1 -1
-2 -2   07 10   09 10   -2 -2   -2 -2   -1 -1   -1 -1   24 22   25 22   26 22   -1 -1   -1 -1   -1 -1   -1 -1   -1 -1   -1 -1   -1 -1   -1 -1
-2 -2   07 10   08 10   09 09   -2 -2   -2 -2   -2 -2   24 23   25 23   26 23   -2 -2   -2 -2   -2 -2   -2 -2   -2 -2   -2 -2   -2 -2   -2 -2
-2 -2   07 11   08 10   08 10   08 09   08 09   08 9    08 10   08 10   08 10   08 09   08 09   08 09   08 09   08 09   08 09   08 09   08 09
-2 -2   -2 -2   07 11   08 11   08 11   08 11   08 10   08 10   08 11   08 11   08 11   08 11   08 11   08 11   08 11   08 11   08 11   08 11
-1 -1   -2 -2   -2 -2   -2 -2   -2 -2   -2 -2   07 10   09 10   -2 -2   -2 -2   -2 -2   -2 -2   -2 -2   -2 -2   -2 -2   -2 -2   -2 -2   -2 -2
-1 -1   -1 -1   -1 -1   -1 -1   -1 -1   -2 -2   07 10   09 10   -2 -2   -1 -1   -1 -1   -1 -1   -1 -1   -1 -1   -1 -1   -1 -1   -1 -1   -1 -1
-1 -1   -1 -1   -1 -1   -1 -1   -1 -1   -2 -2   07 10   09 10   -2 -2   -1 -1   -1 -1   -1 -1   -1 -1   -1 -1   -1 -1   -1 -1   -1 -1   -1 -1